4
P
1 173 150 1 2
0 100 120 0 1
0 100 60 0 1
3 173 30 1 2
0 100 180 0 1
0 0 0 0 3
0 100 0 0 1
0 100 240 0 1
0 100 300 0 1
5 173 270 1 2

1 1 0 0 1 0 0 0 0 0
1 1 1 0 1 1 0 0 0 0
0 1 1 1 0 1 1 0 0 0
1 1 0 0 1 1 0 1 0 0
0 1 1 0 1 1 1 1 1 0
0 0 0 0 1 1 0 1 1 1
0 0 0 0 0 1 1 1 1 1
0 0 0 0 0 0 0 1 1 1
