10
P
0 75
1 346 150 1 2
0 200 120 0 1
0 200 60 0 1
3 346 30 1 2
0 200 180 0 1
0 0 0 0 3
0 200 0 0 1
0 200 240 0 1
0 200 300 0 1
5 346 270 1 2
1 1 0 0 1 0 0 0 0 0
1 1 1 0 1 1 0 0 0 0
0 1 1 1 0 1 1 0 0 0
0 0 1 1 0 1 1 0 0 0
1 1 0 0 1 1 0 1 0 0
0 1 1 0 1 1 1 1 1 0
0 0 1 1 0 1 1 0 1 0
0 0 0 0 1 1 0 1 1 1
0 0 0 0 0 1 1 1 1 1
0 0 0 0 0 0 0 1 1 1
