12
0	0.5	0.1	0	1
1	0.3	0.2	1	2
5	0.7	0.2	1	2
0	0.35	0.5	0	1
0	0.65	0.5	0	1
0	0.2	0.5	0	1
0	0.8	0.5	0	1
0	0.5	0.35	0	1
0	0.5	0.65	0	1
5	0.3	0.8	1	2
1	0.7	0.8	1	2
0	0.5	0.9	0	1
1 1 1 1 0 0 0 0 0 0 0 0
1 1 0 1 0 1 0 1 0 0 0 0
1 0 1 1 0 0 1 0 1 0 0 0
1 1 1 1 1 0 0 1 1 0 0 0
0 0 0 1 1 0 0 1 1 1 1 1
0 1 0 0 0 1 0 1 0 1 0 0
0 0 1 0 0 0 1 0 1 0 1 0
0 1 0 1 1 1 0 1 1 1 0 0
0 0 1 1 1 0 1 1 1 0 1 0
0 0 0 0 1 1 0 1 0 1 0 1
0 0 0 0 1 0 1 0 1 0 1 1
0 0 0 0 1 0 0 0 0 1 1 1

