14
P
0 75
3	300	150	1	1
0	260	180	0	1
1	300	210	1	1
0	150	150	0	2
0	150	210	0	2
0	150	90	0	2
0	0	0	0	2
0	150	270	0	2
5	300	270	2	2
0	150	30	0	2
0	150	330	0	2
3	300	30	1	1
0	260	0	0	1
1	300	330	1	1
1 1 0 1 0 0 0 0 0 0 0 0 0 0
1 1 1 1 1 0 0 0 0 0 0 0 0 0
0 1 1 0 1 0 0 0 0 0 0 0 0 0
1 1 0 1 1 1 1 0 0 0 0 0 0 0
0 1 1 1 1 0 1 1 0 0 0 0 0 0
0 0 0 1 0 1 1 0 0 1 0 0 0 0
0 0 0 1 1 1 1 1 0 1 1 0 0 0
0 0 0 0 1 0 1 1 1 0 1 0 0 0
0 0 0 0 0 0 0 1 1 0 0 0 0 0
0 0 0 0 0 1 1 0 0 1 1 1 1 0
0 0 0 0 0 0 1 1 0 1 1 0 1 1
0 0 0 0 0 0 0 0 0 1 0 1 1 0
0 0 0 0 0 0 0 0 0 1 1 1 1 1
0 0 0 0 0 0 0 0 0 0 1 0 1 1
