14
P
0 50
0	0	0	0	1
0	150	0	0	1
0	150	60	0	1
0	150	120	0	1
0	150	180	0	1
0	150	240	0	1
0	150	300	0	1
0	420	15	0	1
3	300	0	1	2
0	420	345	0	1
0	420	165	0	1
5	300	180	1	2
0	420	195	0	1
1	260	270	1	3
1 1 1 1 1 1 1 0 0 0 0 0 0 0
1 1 1 0 0 0 1 0 1 0 0 0 0 0
1 1 1 1 0 0 0 0 0 0 0 0 0 0
1 0 1 1 1 0 0 0 0 0 0 0 0 0
1 0 0 1 1 1 0 0 0 0 0 1 0 0
1 0 0 0 1 1 1 0 0 0 0 0 0 1
1 1 0 0 0 1 1 0 0 0 0 0 0 1
0 0 0 0 0 0 0 1 1 1 0 0 0 0
0 1 0 0 0 0 0 1 1 1 0 0 0 0
0 0 0 0 0 0 0 1 1 1 0 0 0 0
0 0 0 0 0 0 0 0 0 0 1 1 1 0
0 0 0 0 1 0 0 0 0 0 1 1 1 0
0 0 0 0 0 0 0 0 0 0 1 1 1 0
0 0 0 0 0 1 1 0 0 0 0 0 0 1
