12
P
0 0
0	140	0	0	1
0	140	90	0	1
0	140	180	0	1
0	140	270	0	1
0	285	0	0	1
0	285	90	0	1
0	285	180	0	1
0	285	270	0	1
1	300	45	1	2
3	300	135	1	2
5	300	225	1	2
7	300	315	1	2

1 1 0 1 1 0 0 0 1 0 0 1
1 1 1 0 0 1 0 0 1 1 0 0
0 1 1 1 0 0 1 0 0 1 1 0
1 0 1 1 0 0 0 1 0 0 1 1
1 0 0 0 1 0 0 0 1 0 0 1
0 1 0 0 0 1 0 0 1 1 0 0
0 0 1 0 0 0 1 0 0 1 1 0
0 0 0 1 0 0 0 1 0 0 1 1
1 1 0 0 1 1 0 0 1 0 0 0
0 1 1 0 0 1 1 0 0 1 0 0
0 0 1 1 0 0 1 1 0 0 1 0
1 0 0 1 1 0 0 1 0 0 0 1
