10
P
0 0
0 160 30 0 2
0 160 90 0 2
0 160 150 0 2
0 160 210 0 2
0 160 270 0 2
0 160 330 0 2
1 450 35 1 2
3 450 145 1 2
5 450 215 1 2
7 450 325 1 2
1 1 1 1 1 1 1 0 0 1
1 1 1 1 1 1 1 1 0 1
1 1 1 1 1 1 0 1 1 0
1 1 1 1 1 1 0 1 1 0
1 1 1 1 1 1 0 0 1 1
1 1 1 1 1 1 1 0 0 1
1 1 0 0 0 1 1 0 0 1
0 1 1 1 0 0 0 1 1 0
0 0 1 1 1 0 0 1 1 0
1 0 0 0 1 1 1 0 0 1
