11
R
3 0.1428 0.16 1 3
5 0.8571 0.16 1 3
0 0.2857 0.33 0 1
0 0.7142 0.33 0 1
0 0.4285 0.5 0 1
0 0.5714 0.5 0 1
0 0.4285 0.66 0 1
0 0.5714 0.66 0 1
0 0.35 0.83 0 1
1 0.5 0.83 1 3
0 0.65 0.83 0 1

1 0 1 0 0 0 0 0 0 0 0
0 1 0 1 0 0 0 0 0 0 0
1 0 1 0 1 0 0 0 0 0 0
0 1 0 1 0 1 0 0 0 0 0
0 0 1 0 1 1 1 1 0 0 0
0 0 0 1 1 1 1 1 0 0 0
0 0 0 0 1 1 1 1 1 1 0
0 0 0 0 1 1 1 1 0 1 1
0 0 0 0 0 0 1 0 1 1 0
0 0 0 0 0 0 1 1 1 1 1
0 0 0 0 0 0 0 1 0 1 1
